しゅほう	主砲	名詞
ふくほう	副砲	名詞
ぎょらい	魚雷	名詞
かんじょうせんとうき	艦上戦闘機	名詞
せんとうき	戦闘機	名詞
かんせん	艦戦	名詞
かんじょうばくげきき	艦上爆撃機	名詞
ばくげきき	爆撃機	名詞
かんばく	艦爆	名詞
かんじょうこうげきき	艦上攻撃機	名詞
こうげきき	攻撃機	名詞
かんこう	艦攻	名詞
かんじょうていさつき	艦上偵察機	名詞
ていさつき	偵察機	名詞
かんてい	艦偵	名詞
すいじょうていさつき	水上偵察機	名詞
すいてい	水偵	名詞
すいじょうばくげきき	水上爆撃機	名詞
すいばく	水爆	名詞
すいじょうせんとうき	水上戦闘機	名詞
すいせん	水戦	名詞
でんたん	電探	名詞
でんぱたんしんぎ	電波探信儀	名詞
そなー	ソナー	名詞
ばくらいとうしゃき	爆雷投射機	名詞
ばくらい	爆雷	名詞
たいかんきょうかだん	対艦強化弾	名詞
たいくうきじゅう	対空機銃	名詞
きじゅう	機銃	名詞
こうしゃそうち	高射装置	名詞
じょうりくようしゅうてい	上陸用舟艇	名詞
たんしょうとう	探照灯	名詞
ばるじ	バルジ	名詞
きかんぶきょうか	旗艦部強化	名詞

しょうこうけい	小口径	名詞
ちゅうこうけい	中口径	名詞
だいこうけい	大口径	名詞
