いきゅう	イ級	固有名詞	駆逐艦
ろきゅう	ロ級	固有名詞	駆逐艦
はきゅう	ハ級	固有名詞	駆逐艦
にきゅう	ニ級	固有名詞	駆逐艦
ほきゅう	ホ級	固有名詞	軽巡洋艦
へきゅう	ヘ級	固有名詞	軽巡洋艦
ときゅう	ト級	固有名詞	軽巡洋艦
ちきゅう	チ級	固有名詞	重雷装巡洋艦
りきゅう	リ級	固有名詞	重巡洋艦
ぬきゅう	ヌ級	固有名詞	軽空母
るきゅう	ル級	固有名詞	戦艦
をきゅう	ヲ級	固有名詞	正規空母
わきゅう	ワ級	固有名詞	補給艦
かきゅう	カ級	固有名詞	潜水艦
よきゅう	ヨ級	固有名詞	潜水艦
たきゅう	タ級	固有名詞	戦艦
れきゅう	レ級	固有名詞	戦艦
そきゅう	ソ級	固有名詞	潜水艦
つきゅう	ツ級	固有名詞	軽巡洋艦
つかす	ツカス	固有名詞	軽巡洋艦
ねきゅう	ネ級	固有名詞	重巡洋艦
