れんしゅうこうかい	練習航海	固有名詞
ちょうきょりれんしゅうこうかい	長距離練習航海	固有名詞
けいびにんむ	警備任務	固有名詞
たいせんけいかいにんむ	対潜警戒任務	固有名詞
かいじょうごえいにんむ	海上護衛任務	固有名詞
ぼうくうしゃげきえんしゅう	防空射撃演習	固有名詞
かんかんしきよこう	観艦式予行	固有名詞
かんかんしき	観艦式	固有名詞

たんかーごえいにんむ	タンカー護衛任務	固有名詞
きょうこうていさつにんむ	強行偵察任務	固有名詞
ぼーきさいとゆそうにんむ	ボーキサイト輸送任務	固有名詞
しげんゆそうにんむ	資源輸送任務	固有名詞
ねずみゆそうさくせん	鼠輸送作戦	固有名詞
ほういりくせんたいてっしゅうさくせん	包囲陸戦隊撤収作戦	固有名詞
おとりきどうぶたいしえんさくせん	囮機動部隊支援作戦	固有名詞
かんたいけっせんえんごさくせん	艦隊決戦援護作戦	固有名詞

てきちていさつさくせん	敵地偵察作戦	固有名詞
こうくうきゆそうさくせん	航空機輸送作戦	固有名詞
ほくごうさくせん	北号作戦	固有名詞
せんすいかんしょうかいにんむ	潜水艦哨戒任務	固有名詞
ほっぽうねずみゆそうさくせん	北方鼠輸送作戦	固有名詞
かんたいえんしゅう	艦隊演習	固有名詞
こうくうせんかんうんようえんしゅう	航空戦艦運用演習	固有名詞
ほっぽうこうろかいじょうごえい	北方航路海上護衛	固有名詞

つうしょうはかいさくせん	通商破壊作戦	固有名詞
てきぼこうくうしゅうさくせん	敵母港空襲作戦	固有名詞
せんすいかんつうしょうはかいさくせん	潜水艦通商破壊作戦	固有名詞
せいほうかいいきふうささくせん	西方海域封鎖作戦	固有名詞
せんすいかんはけんえんしゅう	潜水艦派遣演習	固有名詞
せんすいかんはけんさくせん	潜水艦派遣作戦	固有名詞
かいがいかんとのせっしょく	海外艦との接触	固有名詞
えんようれんしゅうこうかい	遠洋練習航海	固有名詞

MOさくせん	MO作戦	固有名詞
すいじょうきちけんせつ	水上基地建設	固有名詞
とうきょうきゅうこう	東京急行	固有名詞
とうきょうきゅうこう2	東京急行(弐)	固有名詞
えんようせんすいかんさくせん	遠洋潜水艦作戦	固有名詞
すいじょうきぜんせんゆそう	水上機前線輸送	固有名詞
