ながと	長門	固有名詞
むつ	陸奥	固有名詞
いせ	伊勢	固有名詞
ひゅうが	日向	固有名詞
ゆきかぜ	雪風	固有名詞
あかぎ	赤城	固有名詞
かが	加賀	固有名詞
そうりゅう	蒼龍	固有名詞
ひりゅう	飛龍	固有名詞
しまかぜ	島風	固有名詞
ふぶき	吹雪	固有名詞
しらゆき	白雪	固有名詞
はつゆき	初雪	固有名詞
みゆき	深雪	固有名詞
むらくも	叢雲	固有名詞
いそなみ	磯波	固有名詞
あやなみ	綾波	固有名詞
しきなみ	敷波	固有名詞
きたかみ	北上	固有名詞
おおい	大井	固有名詞
こんごう	金剛	固有名詞
ひえい	比叡	固有名詞
はるな	榛名	固有名詞
きりしま	霧島	固有名詞
ほうしょう	鳳翔	固有名詞
ふそう	扶桑	固有名詞
やましろ	山城	固有名詞
てんりゅう	天龍	固有名詞
たつた	龍田	固有名詞
りゅうじょう	龍驤	固有名詞
むつき	睦月	固有名詞
きさらぎ	きさらぎ	固有名詞
さつき	皐月	固有名詞
ふみづき	文月	固有名詞
ながつき	長月	固有名詞
きくづき	菊月	固有名詞
みかづき	三日月	固有名詞
もちづき	望月	固有名詞
くま	球磨	固有名詞
たま	多摩	固有名詞
きそ	木曾	固有名詞
ながら	長良	固有名詞
いすず	五十鈴	固有名詞
なとり	名取	固有名詞
ゆら	由良	固有名詞
せんだい	川内	固有名詞
じんつう	神通	固有名詞
なか	那珂	固有名詞
ちとせ	千歳	固有名詞
ちよだ	千代田	固有名詞
もがみ	最上	固有名詞
ふるたか	古鷹	固有名詞
かこ	加古	固有名詞
あおば	青葉	固有名詞
みょうこう	妙高	固有名詞
あしがら	足柄	固有名詞
なち	那智	固有名詞
はぐろ	羽黒	固有名詞
たかお	高雄	固有名詞
あたご	愛宕	固有名詞
まや	摩耶	固有名詞
ちょうかい	鳥海	固有名詞
とね	利根	固有名詞
ちくま	筑摩	固有名詞
ひよう	飛鷹	固有名詞
じゅんよう	隼鷹	固有名詞
おぼろ	朧	固有名詞
あけぼの	曙	固有名詞
さざなみ	漣	固有名詞
うしお	潮	固有名詞
あかつき	暁	固有名詞
ひびき	響	固有名詞
いかずち	雷	固有名詞
いなづま	電	固有名詞
はつはる	初春	固有名詞
ねのひ	子日	固有名詞
わかば	若葉	固有名詞
はつしも	初霜	固有名詞
しらつゆ	白露	固有名詞
しぐれ	時雨	固有名詞
むらさめ	村雨	固有名詞
ゆうだち	夕立	固有名詞
さみだれ	五月雨	固有名詞
すずかぜ	涼風	固有名詞
あさしお	朝潮	固有名詞
おおしお	大潮	固有名詞
みちしお	満潮	固有名詞
あらしお	荒潮	固有名詞
あられ	霰	固有名詞
かすみ	霞	固有名詞
かげろう	陽炎	固有名詞
しらぬい	不知火	固有名詞
くろしお	黒潮	固有名詞
しょうほう	祥鳳	固有名詞
しょうかく	翔鶴	固有名詞
ずいかく	瑞鶴	固有名詞
きぬ	鬼怒	固有名詞
あぶくま	阿武隈	固有名詞
ゆうばり	夕張	固有名詞
ずいほう	瑞鳳	固有名詞
みくま	三隈	固有名詞
はつかぜ	初風	固有名詞
まいかぜ	舞風	固有名詞
きぬがさ	衣笠	固有名詞
い19	伊19	固有名詞
いく	伊19	固有名詞
すずや	鈴谷	固有名詞
くまの	熊野	固有名詞
い168	伊168	固有名詞
いむや	伊168	固有名詞
い58	伊58	固有名詞
ごーや	伊58	固有名詞
い8	伊8	固有名詞
はち	伊8	固有名詞
はっちゃん	伊8	固有名詞
あはと	伊8	固有名詞
やまと	大和	固有名詞
あきぐも	秋雲	固有名詞
ゆうぐも	夕雲	固有名詞
まきぐも	巻雲	固有名詞
ながなみ	長波	固有名詞
あがの	阿賀野	固有名詞
のしろ	能代	固有名詞
やはぎ	矢矧	固有名詞
さかわ	酒匂	固有名詞
むさし	武蔵	固有名詞
う゛ぇーるぬい	ヴェールヌイ	固有名詞
う゛ぇーるぬい	Верный	固有名詞
たいほう	大鳳	固有名詞
かとり	香取	固有名詞
い401	伊401	固有名詞
しおい	伊401	固有名詞
あきつまる	あきつ丸	固有名詞
かもい	神威	固有名詞
やよい	弥生	固有名詞
うづき	卯月	固有名詞
いぞかぜ	磯風	固有名詞
うらかぜ	浦風	固有名詞
たにかぜ	谷風	固有名詞
はまかぜ	浜風	固有名詞
びすまるく	ビスマルク	固有名詞
びすまるく	Bismarck	固有名詞
びすこ	ビス子	固有名詞
びすこ	Bismarck	固有名詞
れーべれひとまーす	レーベレヒト・マース	固有名詞
れーべれひとまーす	Z1	固有名詞
れーべ	レーベ	固有名詞
z1	レーベレヒト・マース	固有名詞
まっくすしゅるつ	マックス・シュルツ	固有名詞
まっくすしゅるつ	Z3	固有名詞
まっくす	マックス	固有名詞
z3	マックス・シュルツ	固有名詞
ぷりんつおいげん	プリンツ・オイゲン	固有名詞
ぷりんつおいげん	Prinz Eugen	固有名詞
ぷりんつ	プリンツ	固有名詞
ぷりんつ	Prinz	固有名詞
あまつかぜ	天津風	固有名詞
あかし	明石	固有名詞
おおよど	大淀	固有名詞
たいげい	大鯨	固有名詞
りゅうほう	龍鳳	固有名詞
ときつかぜ	時津風	固有名詞
うんりゅう	雲龍	固有名詞
あまぎ	天城	固有名詞
かつらぎ	葛城	固有名詞
はるさめ	春雨	固有名詞
はやしも	早霜	固有名詞
きよしも	清霜	固有名詞
あさぐも	朝雲	固有名詞
やまぐも	山雲	固有名詞
のわき	野分	固有名詞
あきづき	秋月	固有名詞
てるづき	照月	固有名詞
はつづき	初月	固有名詞
たかなみ	高波	固有名詞
あさしも	朝霜	固有名詞
ゆー511	U-511	固有名詞
u511	U-511	固有名詞
ゆーちゃん	U-511	固有名詞
ぐらーふつぇっぺりん	グラーフ・ツェッペリン	固有名詞
ぐらーふつぇっぺりん	Graf Zeppelin	固有名詞
ぐらーふ	グラーフ	固有名詞
ぐらーふ	Graf	固有名詞
ぐらこ	グラ子	固有名詞
ぐらこ	Graf Zeppelin	固有名詞
さらとが	Saratoga	固有名詞
さら	サラ	固有名詞
さら	Sara	固有名詞
ろ511	呂511	固有名詞
ろーちゃん	呂511	固有名詞
うぉーすぱいと	ウォースパイト	固有名詞
うぉーすぱいと	Warspite	固有名詞
すぱこ	スパ子	固有名詞
すぱこ	Warspite	固有名詞
あいおわ	アイオワ	固有名詞
あいおわ	Iowa	固有名詞
りっとりお	リットリオ	固有名詞
りっとりお	Littorio	固有名詞
ろーま	ローマ	固有名詞
ろーま	Roma	固有名詞
りべっちお	リベッチオ	固有名詞
りべっちお	Libeccio	固有名詞
りべ	リベ	固有名詞
あくぃら	アクィラ	固有名詞
あくぃら	Aquila	固有名詞
あきつしま	秋津洲	固有名詞
いたりあ	イタリア	固有名詞
いたりあ	Italia	固有名詞
ざら	ザラ	固有名詞
ざら	Zara	固有名詞
ぽーら	ポーラ	固有名詞
ぽーら	Pola	固有名詞
みずほ	瑞穂	固有名詞
おきなみ	沖波	固有名詞
かざぐも	風雲	固有名詞
あらし	嵐	固有名詞
はぎかぜ	萩風	固有名詞
おやしお	親潮	固有名詞
やまかぜ	山風	固有名詞
うみかぜ	海風	固有名詞
かわかぜ	江風	固有名詞
はやすい	速吸	固有名詞
かしま	鹿島	固有名詞
かみかぜ	神風	固有名詞
あさかぜ	朝風	固有名詞
はるかぜ	春風	固有名詞
まつかぜ	松風	固有名詞
みなづき	水無月	固有名詞
い26	伊26	固有名詞
にむ	伊26	固有名詞
ふじなみ	藤波	固有名詞
うらなみ	浦波	固有名詞
こまんだんてすと	コマンダン・テスト	固有名詞
こまんだんてすと	Commandant Teste	固有名詞
こまちゃん	コマちゃん	固有名詞
こまちゃん	Commandant Teste	固有名詞
い13	伊13	固有名詞
ひとみ	伊13	固有名詞
い14	伊14	固有名詞
いよ	伊14	固有名詞
がんぐーと	ガングート	固有名詞
がんぐーと	Гангут	固有名詞
おくちゃぶりすかやれう゛ぉりゅーつぃや	オクチャブリスカヤ・レヴォリューツィヤ	固有名詞
おくちゃぶりすかやれう゛ぉりゅーつぃや	Октябрьская революция	固有名詞
しむしゅ	占守	固有名詞
くなしり	国後	固有名詞
かすがまる	春日丸	固有名詞
たいよう	大鷹	固有名詞
えとろふ	択捉	固有名詞
