くちくかん	駆逐艦	名詞	艦種
くちく	駆逐	名詞	艦種

けいじゅんようかん	軽巡洋艦	名詞	艦種
けいじゅん	軽巡	名詞	艦種

じゅうらいそうじゅんようかん	重雷装巡洋艦	名詞	艦種
らいじゅん	雷巡	名詞	艦種

れんしゅうじゅんようかん	練習巡洋艦	名詞	艦種
れんじゅん	練巡	名詞	艦種

じゅうじゅんようかん	重巡洋艦	名詞	艦種
じゅうじゅん	重巡	名詞	艦種

こうくうじゅんようかん	航空巡洋艦	名詞	艦種
こうじゅん	航巡	名詞	艦種

せんかん	戦艦	名詞	艦種

こうそくせんかん	高速戦艦	名詞	艦種

こうくうせんかん	航空戦艦	名詞	艦種
こうせん	航戦	名詞	艦種

こうくうぼかん	航空母艦	名詞	艦種
くうぼ	空母	名詞	艦種

せいきくうぼ	正規空母	名詞	艦種
せいくう	正空	名詞	艦種
こう	航	名詞	艦種

そうこうくうぼ	装甲空母	名詞	艦種
そうぼ	装母	名詞	艦種
そうくう	装空	名詞	艦種

けいくうぼ	軽空母	名詞	艦種
けいくう	軽空	名詞	艦種
けいぼ	軽母	名詞	艦種

かいそうくうぼ	改装空母	名詞	艦種

ごえいくうぼ	護衛空母	名詞	艦種

すいじょうきぼかん	水上機母艦	名詞	艦種
すいぼ	水母	名詞	艦種

せんすいかん	潜水艦	名詞	艦種
せん	潜	名詞	艦種

せんすいくうぼ	潜水空母	名詞	艦種
せんぼ	潜母	名詞	艦種

せんすいぼかん	潜水母艦	名詞	艦種
せんぼかん	潜母艦	名詞	艦種

ようりくかん	揚陸艦	名詞	艦種
ようりく	揚陸	名詞	艦種

ほきゅうかん	補給艦	名詞	艦種
ほきゅう	補給	名詞	艦種

こうさくかん	工作艦	名詞	艦種
こう	工	名詞	艦種

かいぼうかん	海防艦	名詞	艦種
かいぼう	海防	名詞	艦種
